is=アイスランド語
az=アゼルバイジャン語
as=アッサム語
ga=アイルランド語
sa=サンスクリット語
af=アフリカーンス語
ar=アラビア語
sq=アルバニア語
hy=アルメニア語
it=イタリア語
yi=イディッシュ語
id=インドネシア語
uk=ウクライナ語
uz=ウズベク語
ur=ウルドゥー語
et=エストニア語
nl=オランダ語
or=オリヤー語
kk=カザフ語
ca=カタロニア語
kn=カナラ語
gl=ガリチア語
el=ギリシア語
kz=キルギスタン語
gu=グジャラート語
ka=グルジア語
hr=クロアチア語
sv=スウェーデン語
gd=スコッチ ゲール語
es=スペイン語
sk=スロヴァキア語
sl=スロヴェニア語
sw=スワヒリ語
sr=セルビア語
sb=ソルビア語
th=タイ語
cs=チェコ語
da=デンマーク語
de=ドイツ語
tr=トルコ語
ne=ネパール語
no=ノルウェー語
eu=バスク語
hu=ハンガリー語
fi=フィンランド語
fo=フェロー語
fr=フランス語
bg=ブルアリア語
vi=ベトナム語
he=ヘブライ語
be=ベラルーシ語
fa=ペルシア語
bn=ベンガル語
pl=ポーランド語
pt=ポルトガル語
mk=マケドニア語
mr=マラーティー語
ml=マラヤラム語
mt=マルタ語
ms=マレー語
lv=ラトビア語
lt=リトニア語
ro=ルーマニア語
rm=レートロマンス語
ru=ロシア語
en=英語
ko=韓国語
zh=中国語
ja=日本語
be=白ロシア語
xh=コーサ語
kok=コンカニ語
syr=シリア語]
zu=ズールー語
sx=スツ語
tt=タタール語
ta=タミール語
ts=ツォンガ語
tn=ツワナ語
div=ディヴェヒ語
te=テルグ語
pa=パンジャブ語
hi=ヒンディー語
mn=モンゴル語
